type octile
height 49
width 49
map
TT.......TTTT.TTT...TTTT.TTTT......T
T........TTT........TTT..TTT.......T
TT.......TTTT............TTTT......T
TT.......TTTT............TTTT......T
TT.......TTTT............TTTT......T
T........TTT.............TTT.......T
T...................................
T...................................
T...................................
TT.......TTTT............TTTT......T
TT.......TTTT............TTTT......T
T........TTT.............TTT.......T
....................................
....................................
....................................
....................................
..............TTT...TTT.............
TT.......TTTT.TTTT..TTTT.TTTT......T
