type octile
height 288
width 225
map
TTTTTTTTTT.........................................................TTTTTTTTTTTTTTTTTTTT.................................................TTTTTTTTTTTTTTTTTTTTTTTTTTTTTTTTTTTTTTTTTTTTTT
TTTTTTTTTT............................................................................................................................................................................
TTTTTTTTTT............................................................................................................................................................................
TTTTTTTTTT............................................................................................................................................................................
TTTTTTTTTT............................................................................................................................................................................
TTTTTTTTT.............................................................................................................................................................................
TTTTTTTTT.............................................................................................................................................................................
TTTTTTTTT.............................................................................................................................................................................
TTTTTTTT..............................................................................................................................................................................
TTTTTTTT..............................................................................................................................................................................
TTTTTTTT..............................................................................................................................................................................
TTTTTTTT.............................................................................................................................................................................T
TTTTTTTT.....................................................................TTT.....................................................................................................T
TTTTTTTT.....................................................................TTT.....................................................................................................T
TTTTTTTT..............................................................................................................................................................................
TTTTTTTT...............TTTT...........................................................................................................................................................
TTTTTTTTT..............TTTT...........................................................................................................................................................
TTTTTTTTT..............TTTT...........................................................................................................................................................
TTTTTTTTT...............TT..................................................................................................................................................TT........
TTTTTTTTT...................................................................................................................................................................TT........
TTTTTTTTT.............................................................................................................................................................................
TTTTTTTTTTTTT.........................................................................................................................................................................
TTTTTTTTTTTTTT........................................................................................................................................................................
TTTTTTTTTTTTTT........................................................................................................................................................................
TTTTTTTTTTTTT...................................................................................................TT....................................................................
TTTTTTTTTTTTTT.................................................................................................TTTT...................................................................
TTTTTTTTTTTTTTT................................................................................................TTTT...................................................................
TTTTTTTTTTTTTTT................................................................................................TTTT...................................................................
TTTTTTTTTTTTTTT.......................................................................................................................................................................
TTTTTTTTTTTTTTT.............................................................................................................................................................TT........
TTTTTTTTTTTTTTT..................................................................................................................................................TT.........TT........
TTTTTTTTTTTTTTT.....................................................................TT...........................................................................TT...................
TTTTTTTTTTTTTTTT...................................................................TTT................................................................................................
TTTTTTTTTTTTTTTTT...................................................................TT................................................................................................
TTTTTTTTTTTTTTTTTT......................................TTTT...................................TT.....................................................................................
TTTTTTTTTTTTTTTTTTT......................................TTTT..................................TT.....................................................................................
TTTTTTTTTTTT..TTTTTT.....................................T.TTT........................................................................................................................
TTTTTTTTTTTT...TTTTT.......................................TTTT.......................................................................................................................
TTTTTTTTTTTT.....TTTTT.....................................TTTTT......................................................................................................................
TTTTTTTTTTTT.....TTTTT................T.....................TTTT......................................................................................................................
TTTTTTTTTTT.....TTTTTT................T......................T........................................................................................................................
TTTTTTTTTTT.....TTTTTT................TT..............................................................................................................................................
TTTTTTTTTT......TTTTTT.................T..............................................................................................................................................
TTTTTTTTTT.....TTT.TTTT................T..............................................................................................................................................
TTTTTTTTTT.....T...TTTTT...............TT.............................................................................................................................................
TTTTTTTTTT............TT.T..............T...........................................................................TTT...............TT..............................................
TTTTTTTTTT.............T.TT.............T...........................................................................TTT...............TT..............................................
TTTTTTTTTT................T.............TTT...............................................................................................TTTT........................................
TTTTTTTTTT.................T.............TTT.........................................................................TTT..................TTTT........................................
TTTTTTTTTT.................TT..........TTTTTT......................................T.................................TTT........TT........TTTT........................................
TTTTTTTTTT............................TT..TTTT....................................TT......TTTTT.................................TT.........TT.........................................
TTTTTTTTTT...........................TT...TTTT.....................T......................TT..........................................................................................
TTTTTTTTT................T.........TTT.....TTT.....................T............................................................................TT....................................
TTTTTTTTT.................T..TTT..TT........TTT....................T............................................................................TT....................................
TTTTTTTTT...T.................TTTTTT..........TTTT...TTT...........T.......T.T........................................................................................................
TTTTTTTTT......................TTT.TT............TTTTT..............TTT...TTTTTT......................................................................................................
TTTTTTTT............................TT...............TTTTTTTTTTTTTT...TTTTTTTTTT...T..................................................................................................
TTTTTTTT....T........................TT...........................TTTTTTTTTTTTTTT..TT.................................................................................................
TTTTTTTT..............................T.......................................TTTTTTT.................................................................................................
TTTTTTTT..............................T.........................T..............TTTTTT........................TT.......................................................................
TTTTTTTT............................TTT.........................T................TTTTT........TT.............TTT..............................................................TTTTTT..
TTTTTTTT.T..........................TTT...........................................TTTTT..TTTT.TTTT..........T.TT...............................................................TTTT...
TTTTTTTTTT...........................TT.............................................TTTT.TTTTTTTTTTT...........TT.........T.....................................................TT....
TTTTTTTTTTT..........................T...............................................TTT......TTTTTTTT........TTTT........T......................................................TTTTT
TTTTTTTTTT...........................T.................................................TTTTTTTTTTTTTTTT......TTTTTTT.......TT...............TT.....TT.............................TTTT
TTTTTTTT.TT.........................TT..............................................................TTTT..TTTTTTTTTTT.TTTT.TTTT..........TTTTTTTTTTTTTT............................TTT
TTTTTTTT.TT.......................TTT....................................................................TTTTTTTTTTTTTTTTT.TTTTTT.....TTTTT....TTTTTTTTT.........T..................TT
TTTTTTTT..T.................T.....TTT........................................................................T........TTT.......TTTT..TT.....TTT..TTTTTTT.......TTTT.................T
TTTTTTTT..T.................TTT...T.TT.......................................................................T..........TT...........................TTTTT......TTTT..................
TTTTTTTT...................TTT.......TTT.................................................................................TT..........................TTTTTT......TT...................
TTTTTTTT...................TT.T........TT.................................................................................TT................TT.........TT.............................
TTTTTTTT...................T...T........TT.................................................................................TTT..............TT........................................
TTTTTTTT.......................T.........TTT.................................................................................TT.......................................................
TTTTTTTT.........................T.......TTTTT................................................................................TT......................................................
TTTTTTTT.........................T...........TTT...............................................................................TT.....................................................
TTTTTTTT...................T....TTT...........TT................................................................................TT....................................................
TTTTTTTT...................TTTT..TTT...........TT................................................................................TT.......................T...........................
TTTTTTTT...................TTTT..TTTT...........T.................................................................................TTTTTTT..........TT.....T...........................
TTTTTTTT....................TT.T.TTTTT..........TT......................................................................................T...............T.............................
TTTTTTTT.....................T..TTTT.......T.....T......................................................................................TT..............TT............................
TTTTTTTT.........................TTTT.....T......TTT.....................................................................................T..............TT............................
TTTTTTTT.........................TTTT........T.....TTT...................................................................................T..............T.............................
TTTTTTTT.........................TTTTTT...TTTTT......TTT...TT............................................................................T..T...........TT............................
TTTTTTTT.........................TTT.TTTT..TTTTTT.....TTTTTTTT...........................................................................TT.............TT............................
TTTTTTTT.....................................TTTTT....TT.....TTT.........................................................................TTT............TT............................
TTTTTTTTT......................................TTT.............TT........................................................................TT.......TT.....T............................
TTTTTTTTT.......................................TTT.............TTT......................................................................TT.......TT..................................
TTTTTTTTT.........................................TTTT...........TTTT....................................................................TT...........................................
TTTTTTTTTT..........................................................TTTT.................................................................TT...........................................
TTTTTTTTTTTT..........................................................TTT.................................................................TT...............T..........................
TTTTTTTTTTTT............................................................TT.......................................TT.......................TTT..............TT.........................
TTTTTTTTTTTT.............................................................TT...................................TTTTTTTT....................TTTT.............TT.........................
TTTTTTTTTTTT.........................................................T....T...................................TTTTTTTTTT..................TTTTTT............TT........................
TTTTTTTTTTT..........................................................T....TT.............T...........TTTTTTTTTTTTTTTTTTTTT................TTTTTTTT...........TT.......................
TTTTTTTTTTT................................................................TTTTTTTTTTTTTTTTTT.....TTTTTTTTTTTTTTTTTTTTTTTTTT...............TTTTTTT...........TTT......................
TTTTTTTTTTT.................................................................................TTTTTTTTTTTTTTTTTTTTTTTTTTTTTTTT................TTTTTT...........TTT......................
TTTTTTTTTTTTTTTTT................T...TTTT.TT............................TTTT.....TT...TTTTTTTTTTTTTTTTTTTTTTTTTTTTTTTTTTTTTTT................TTTT.............TTT.....................
TTTTTTTTTTTTTTTTTT.............TTTTTTTTTTTT...............TTTTTTTTTTT.TTTTTTTTTTTTTTTTTTTTTTTTTTTTTTTTTTTTTTTTTTTTTTTTTTTTTTT...................TTT............TTTTT..................
TTTTTTTTTTTTTTTTTTT..........TTTTTTTT.TTTTTT............TTTTTTTTTTTTTTTTTTTTTTTTTTTTTTTTTTTTTTTTTTTT.......TTTTTTTTTTTTTTTTTT.....................TTT...........TTTTT.................
TTTTTTTTTTTTTTTTTTTT......TTTTTTTTTT..TTTTTT...........TTTTTTTTTTTTTTTTTTTT...................................TTTTTTTTTTTTTT........................TT..........TTTTT.T...............
TTTTTTTTTT...TTTTTTTTTT.TTTT..TTTT....TTTTTT.........T.TTTTTTTTTTTTT..............................................TTTTTTTTT..........................TT..........T....................
TTTTTTTTTT...TTTTTT..T..TTTTT.........TTTTT.........TT.TTTTTTTT.......................................................................................T...........T...................
TTTTTTTTTT...TTT.......TTTTTTT.........TTT..........TTTTTTTTT.........................................................................................TT..........TT..................
TTTTTTTTTT................TTTT....................TTTTTTTTTT...........................................................................................TT.............................
TTTTTTTTTTT.................TT...................TTTTTTTTT..............................................................................................T.............................
TTTTTTTTTTT.................TTTTT................TTTTTTT................................................................................................TT............................
TTTTTTTTTTTTT................TTTTT...............TTTTTT..................................................................................................TT........T..................
TTTTTTTTTTTTT....................TT.............TTTTTTT...................................................................................................T.......TT..................
TTTTTTTTTTTTT.....................T.............TTTTTT....................................................................................................T.......TT..................
TTTTTTTTTTTTTT..................................TTTTT.....................................................................................................T.........T.................
TTTTTTTTTTTTTT.................................TTTTT......................................................................................................T.........T.................
TTTTTTTTTTTTTTT................................TTTT.......................................................................................................TT........TT................
TTTTTTTTTTTTTTT..............................T.TTTT........................................................................................................T........TT................
TTTTTTTTTTTTTTTT.............................TTTTT.........................................................................................................T........TT................
TTTTTTTTTTTTTTTT...............................TT..........................................................................................................T........T.................
TTTTTTTTTTTTTTTTT.............................TT...........................................................................................................T........T.................
TTTTTTTTTTTTTTTTT.............................T............................................................................................................T.........TTT..............
TTTTTTTTTTTTTTTTT............................TT............................................................................................................T.........TTT..............
TTTTTTTTTTTTTTTTTT.........................TTT.............................................................................................................T.........TTT..............
TTTTTTTTTTTTTTTTTTT.......................TT...............................................................................................................T.........TTT..............
TTTTTTTTTTTTTTTTTTT......................TT................................................................................................................T.........TTTT.............
TTTTTTTTTTTTTTTTTTTT...................TTT.................................................................................................................T..........TTTT............
TTTTTTTTTTTTTTTTTTTT..................TT...................................................................................................................T...........TTTT...........
TTTTTTTTTTTTTTTTTTTTT....TT......T..TTT....................................................................................................................T............TTT.T.........
TTTTTTTTTTTTTTTTTTTTT.....TTT....TTTT......................................................................................................................T.............TT...........
