type octile
height 288
width 225
map
TTTTTTTTTT.........................................................TTTTTTTTTTTTTTTTTTTT...........................................
TTTTTTTTTT........................................................................................................................
TTTTTTTTTT........................................................................................................................
TTTTTTTTTT........................................................................................................................
TTTTTTTTTT........................................................................................................................
TTTTTTTTT.........................................................................................................................
TTTTTTTTT.........................................................................................................................
TTTTTTTTT.........................................................................................................................
TTTTTTTT..........................................................................................................................
TTTTTTTT..........................................................................................................................
TTTTTTTT..........................................................................................................................
TTTTTTTT..........................................................................................................................
TTTTTTTT.....................................................................TTT..................................................
TTTTTTTT.....................................................................TTT..................................................
TTTTTTTT..........................................................................................................................
TTTTTTTT...............TTTT.......................................................................................................
TTTTTTTTT..............TTTT.......................................................................................................
TTTTTTTTT..............TTTT.......................................................................................................
TTTTTTTTT...............TT........................................................................................................
TTTTTTTTT.........................................................................................................................
TTTTTTTTT.........................................................................................................................
TTTTTTTTTTTTT.....................................................................................................................
TTTTTTTTTTTTTT....................................................................................................................
TTTTTTTTTTTTTT....................................................................................................................
TTTTTTTTTTTTT...................................................................................................TT................
TTTTTTTTTTTTTT.................................................................................................TTTT...............
TTTTTTTTTTTTTTT................................................................................................TTTT...............
TTTTTTTTTTTTTTT................................................................................................TTTT...............
TTTTTTTTTTTTTTT...................................................................................................................
TTTTTTTTTTTTTTT...................................................................................................................
TTTTTTTTTTTTTTT...................................................................................................................
TTTTTTTTTTTTTTT.....................................................................TT............................................
TTTTTTTTTTTTTTTT...................................................................TTT............................................
TTTTTTTTTTTTTTTTT...................................................................TT............................................
TTTTTTTTTTTTTTTTTT......................................TTTT...................................TT.................................
TTTTTTTTTTTTTTTTTTT......................................TTTT..................................TT.................................
TTTTTTTTTTTT..TTTTTT.....................................T.TTT....................................................................
TTTTTTTTTTTT...TTTTT.......................................TTTT...................................................................
TTTTTTTTTTTT.....TTTTT.....................................TTTTT..................................................................
TTTTTTTTTTTT.....TTTTT................T.....................TTTT..................................................................
TTTTTTTTTTT.....TTTTTT................T......................T....................................................................
TTTTTTTTTTT.....TTTTTT................TT..........................................................................................
TTTTTTTTTT......TTTTTT.................T..........................................................................................
TTTTTTTTTT.....TTT.TTTT................T..........................................................................................
TTTTTTTTTT.....T...TTTTT...............TT.........................................................................................
TTTTTTTTTT............TT.T..............T...........................................................................TTT...........
TTTTTTTTTT.............T.TT.............T...........................................................................TTT...........
TTTTTTTTTT................T.............TTT.......................................................................................
TTTTTTTTTT.................T.............TTT.........................................................................TTT..........
TTTTTTTTTT.................TT..........TTTTTT......................................T.................................TTT........TT
TTTTTTTTTT............................TT..TTTT....................................TT......TTTTT.................................TT
TTTTTTTTTT...........................TT...TTTT.....................T......................TT......................................
TTTTTTTTT................T.........TTT.....TTT.....................T..............................................................
TTTTTTTTT.................T..TTT..TT........TTT....................T..............................................................
