type octile
height 49
width 49
map
...T.T..
...T.T..
.....T..
.....T..
.T...T..
.TT.....
.TTT....
