type octile
height 49
width 49
map
..TT.T..
..TT.T..
.....T..
.....T..
TT...T..
.TT..T..
.TT.....
.TT.....
