type octile
height 49
width 49
map
...T.T...
.....T...
TT...T...
TT...T...
.....T...
.TT..T...
.TT......
.TT......
