type octile
height 1 
width 1
map
...
...
...
..T
...
T..
...
...
